WWWWWWWWWWWWWWWWWWWW
WFFFFFFFFFFFFFFFFFFW
WFFFFFFFFFFFFFFFFFFW
WFFFFFFFFFFFFFFFFFFW
WFFFFFFFWWWWFFFFFFFW
WFFFFFFFW  WFFFFFFFW
WFFFFFFFWWWWFFFFFFFF
WFFFFFFFFFFFFFFFFFFF
WFFFFFFFFFFFFFFFFFFF
WFFFFWWWWWWWFFFFFWWW
WFFFFW
WFFFFW
WWWWWW