WWWWWWWWWWWWWWWWWWWW
WFFFFFFFFFFFFFFFFFFW
WFFFFFFFFFFFWFFFFFFW
WFFFFFFFFFFFFFFFFFFW
WFFFFFFFFFFFFFFFFFFW
WFFFFFFFFFFFFFFFFFFW
WFFFFFFFFFFFFFFFFFF
WFFFFFFFFFFFFWFFFFFF
WFFFFFFFFFFFFWWWWWWW
WFFFFWFFFWWWWW
WFFFFWFFFW
WWWWWWFFFW