WWWWWWWWWWWWWWWWWWWW
WFFFFFFFFFFFWFFFFFFW
WFFFFFFFFFFFFFFFFFFW
WFFFFFFFFFFFWFFFFFFW
WFFFFFFFFFFFFFFFFFFW
WFFFFFFFFFFFFFFFFFFW
WFFFFFFFFFFFWFFFFFF
WFFFFFFFFFFFFFFFFFF
WFFFFFFFFFFFFWWWWWWW
WFFFFWFFFWWWWW
WFFFFWFFFW
WWWWWWFFFW