WWWWWWWWWWWWWWWWWWWW
WFFFFFFFFFFFFFFFFFFW
WFFFFFFFFFFFFFFFFFFW
WFFFFFFFFFFFFFFFFFFW
WFFFFFFFFFFFFFFFFFFW
WFFFFFFFFFFFFFFFFFFW
WFFFFFFFFFFFFWFFFFFF
WFFFFFFFFFFFFWFFFFFF
WFFFFFFFFFFFFWWWWWWW
WFFFFWFFFWWWWW
WFFFFWFFFW
WWWWWWFFFW